Absurd	(ridiculous, senseless, foolish) [Core Expansion 2, Party Box]
Abundant	(plentiful, ample, numerous) [Core Expansion 2]
Addictive	(obsessive, consuming, captivating) [Core Expansion 1, Party Box]
Adorable	(lovable, charming, delightful) [Core Set, Party Box]
Aged	(old, ancient, mature) [Core Expansion 2, Party Box]
Amazing	(astonishing, surprising, wonderful) [Core Expansion 3, Party Expansion 1]
American	(U.S. Citizen, Yankee, Apple Pie) [Core Expansion 2, Party Box]
Ancient	(elderly, old, antique) [Core Set, Party Box]
Animated	(lively, exuberant, spirited) [Core Set, Party Box]
Annoying	(irritating, bothersome, teasing) [Core Expansion 1, Party Box]
Appetizing	(appealing, tasty, flavorful) [Core Expansion 2, Party Box]
Armed & Dangerous	(hazardous, threatening, fortified) [Core Expansion 4, Party Expansion 1]
Arrogant	(egotistical, overconfident, conceited) [Core Set, Party Box]
Attractive	(alluring, engaging, good-looking) [Core Expansion 3, Party Expansion 1]
Awesome	(amazing, remarkable, majestic) [Core Expansion 1, Party Box]
Awkward	(clumsy, bumbling, uncoordinated) [Core Set, Party Box]
Bashful	(shy, timid, modest) [Core Expansion 3, Party Expansion 1]
Believable	(trustworthy, credible, convincing) [Core Expansion 1, Party Box]
Big	(large, huge) [Kids Set]
Big & Tall	(large, bulky, gigantic) [Core Expansion 4, Party Expansion 1]
Black & Blue	(bruised, battered, rough) [Core Expansion 4, Party Expansion 1]
Black & White	(indisputable, distinct, written) [Core Expansion 4, Party Expansion 1]
Bogus	(fraudulent, phony, insincere) [Core Expansion 1, Party Box]
Boisterous	(loud, rambunctious, rowdy) [Core Set, Party Box]
Bold	(daring, brave, courageous) [Core Expansion 1, Party Box]
Boring	(dull, tedious, monotonous) [Core Set, Party Box]
Brains & Brawn	(solid, strong, capable) [Core Expansion 4, Party Expansion 1]
Bright	(brilliant, radiant, shiny) [Core Expansion 1, Party Box]
Bright & Shining	(radiant, sparkling, gleaming) [Core Expansion 4, Party Expansion 1]
Brilliant	(dazzling, gleaming, intelligent) [Core Set, Party Box]
Brutal	(cruel, crude, harsh) [Core Expansion 3, Party Expansion 1]
Busy	(occupied, meddlesome, engrossed) [Core Expansion 2, Party Box]
Calm	(peaceful, tranquil, placid) [Core Set, Party Box]
Careful	(cautious, thoughtful) [Junior Set (1st) & (2nd)]
Casual	(easygoing, blase, nonchalant) [Core Set, Party Box]
Charismatic	(alluring, magnetic, charming) [Core Expansion 2, Party Box]
Charming	(captivating, enchanting, fascinating) [Core Set, Party Box]
Cheerful	(happy, lively) [Junior Set (1st) & (2nd)]
Cheesy	(trashy, tawdry, far-fetched) [Core Set, Party Box]
Chewy	(gummy, rubbery, stringy) [Core Expansion 1, Party Box]
Chubby	(plump, round) [Junior Set (2nd)]
Chunky	(lumpy, chubby, bumpy) [Core Expansion 1, Party Box]
Classic	(timeless, definitive, vintage) [Core Expansion 1, Party Box]
Clean	(washed, pure, tidy) [Core Expansion 2, Party Box]
Clear	(understandable, uncluttered, transparent) [Core Expansion 1]
Clever	(intelligent, ingenious, witty) [Core Expansion 3, Party Expansion 1]
Clueless	(unaware, oblivious, ignorant) [Core Expansion 1, Party Box]
Clumsy	(awkward, bumbling, uncoordinated) [Core Expansion 3, Party Expansion 1]
Cold	(chilly, icy, aloof) [Core Expansion 2, Party Box]
Colorful	(vivid, brilliant, kaleidoscopic) [Core Set, Party Box]
Comfortable	(cozy, snug, restful) [Core Expansion 2, Party Box]
Comical	(funny, hilarious, amusing) [Core Expansion 2, Party Box]
Complicated	(difficult, complex, involved) [Core Expansion 1, Party Box]
Conceited	(vain, smug, self-centered) [Core Expansion 3, Party Expansion 1]
Confused	(muddled, bewildered, perplexed) [Core Expansion 1, Party Box]
Controversial	(contentious, disputable, debatable) [Core Expansion 3, Party Expansion 1]
Cool	(chilly, hip, cold-blooded) [Core Set, Party Box]
Cool & Collected	(controlled, composed, restrained) [Core Expansion 4, Party Expansion 1]
Corrupt	(dishonest, underhanded, shady) [Core Set, Party Box]
Cosmic	(limitless, planetary, far out) [Core Expansion 2, Party Box]
Cosmopolitan	(sophisticated, urbane, well-informed) [Party Box]
Courageous	(brave, gallant, dauntless) [Core Set, Party Box]
Cowardly	(fearful, afraid, spineless) [Core Expansion 1, Party Box]
Cozy	(comfortable, snug, warm) [Core Expansion 3, Party Expansion 1]
Cranky	(crabby, cantankerous, grouchy) [Core Expansion 2, Party Box]
Crazed	(insane, wild, deranged) [Core Set, Party Box]
Crazy	(insane, bizarre, wacky) [Core Expansion 1, Party Box]
Creative	(imaginative, artistic, original) [Core Set, Party Box]
Creepy	(frightening, slithering, scary) [Core Set, Party Box]
Creepy & Crawly	(frightening, ghastly, icky) [Core Expansion 4, Party Expansion 1]
Crisp	(brittle, brisk, fresh) [Core Expansion 3, Party Expansion 1]
Crisp & Delicious	(tasty, crunchy, savory) [Core Expansion 4, Party Expansion 1]
Cruel	(mean, harsh, merciless) [Party Box]
Cruel & Unusual	(barbaric, merciless, unwarranted) [Core Expansion 4, Party Expansion 1]
Cuddly	(loving, tender, huggable) [Core Set, Party Box]
Curved	(bent, rounded) [Junior Set (2nd)]
Cut & Dried	(settled, obvious, indisputable) [Core Expansion 4, Party Expansion 1]
Cute	(pretty, perky, delightful) [Core Expansion 2, Party Box]
Cute & Cuddly	(adorable, precious, huggable) [Core Expansion 4, Party Expansion 1]
Dainty	(delicate, fragile, thin) [Core Set, Party Box]
Dangerous	(risky, chancy, hazardous) [Core Set, Party Box]
Daring	(brave, bold) [Junior Set (2nd)]
Dark	(unlit, morbid, sinister) [Core Expansion 3, Party Expansion 1]
Dashing	(gallant, bold, elegant) [Core Expansion 3, Party Expansion 1]
Dazed & Confused	(stunned, bewildered, disoriented) [Core Expansion 4, Party Expansion 1]
Dead	(deceased, expired, unresponsive) [Core Expansion 2, Party Box]
Dead & Gone	(deceased, defunct, passe) [Core Expansion 4, Party Expansion 1]
Deadly	(fatal, lethal, murderous) [Core Expansion 1, Party Box]
Delicate	(dainty, tender, elegant) [Core Set, Party Box]
Delicious	(tasty, pleasing, appetizing) [Core Set, Party Box]
Delightful	(pleasing, enjoyable, charming) [Core Expansion 1, Party Box]
Demanding	(difficult, exacting, bothersome) [Core Set, Party Box]
Depressing	(dismal, gloomy, sad) [Core Expansion 2, Party Box]
Desperate	(frantic, headlong, reckless) [Core Set, Party Box]
Devious	(sneaky, shifty, tricky) [Core Expansion 3, Party Expansion 1]
Dignified	(stately, honorable, distinguished) [Core Expansion 1, Party Box]
Dirty	(unclean, soiled, impure) [Core Expansion 2, Party Box]
Disgusting	(sickening, horrible) [Junior Set (2nd)]
Distinguished	(dignified, extraordinary, acclaimed) [Core Set, Party Box]
Disturbing	(unsettling, troubling, worrisome) [Core Expansion 1, Party Box]
Down & Dirty	(nasty, vicious, unscrupulous) [Core Expansion 4, Party Expansion 1]
Down & Out	(destitute, impoverished, penniless) [Core Expansion 4, Party Expansion 1]
Dramatic	(exciting, sensational, theatrical) [Core Set, Party Box]
Dreamy	(fanciful, whimsical, heavenly) [Core Expansion 1, Party Box]
Drunk & Disorderly	(intoxicated, unruly, rowdy) [Core Expansion 4, Party Expansion 1]
Dull	(boring, stupid, blunt) [Party Box]
Dumb	(silent, not smart) [Junior Set (2nd)]
Dumb & Dumber	(stupid, dull, rediculous) [Core Expansion 4, Party Expansion 1]
Dysfunctional	(impaired, damaged, maladjusted) [Core Expansion 2, Party Box]
Earthy	(unrefined, natural, crude) [Core Set, Party Box]
Easy	(effortless, gentle, promiscuous) [Core Set, Party Box]
Eccentric	(peculiar, odd, bizarre) [Core Expansion 2, Party Box]
Edgy	(irritable, nervous, tense) [Core Expansion 3, Party Expansion 1]
Elitist	(snobbish, arrogant, smug) [Core Expansion 2, Party Box]
Emotional	(passionate, moving, volatile) [Core Expansion 2, Party Box]
Enchanting	(captivating, charming, spell-binding) [Core Expansion 3, Party Expansion 1]
Endangered	(at risk, threatened, unprotected) [Core Expansion 3, Party Expansion 1]
Energetic	(active, vigorous, forceful) [Core Expansion 3, Party Expansion 1]
Enjoyable	(pleasurable, entertaining, fun) [Core Expansion 3, Party Expansion 1]
Enormous	(large, huge, gigantic) [Core Expansion 3, Party Expansion 1]
Entertaining	(amusing, festive, enjoyable) [Core Expansion 3, Party Expansion 1]
Eternal	(timeless, immortal, perpetual) [Core Expansion 2, Party Box]
European	(of Europe, from Europe, about Europe) [Core Expansion 2, Party Box]
Evil	(wicked, corrupt, depraved) [Core Expansion 3, Party Expansion 1]
Exciting	(thrilling, breathtaking, arousing) [Core Expansion 1, Party Box]
Exhausting	(weakening, tiring, draining) [Core Expansion 2, Party Box]
Expensive	(costly, valuable, exorbitant) [Core Set, Party Box]
Explosive	(bursting, blasting, dangerous) [Core Expansion 1, Party Box]
Exquisite	(excellent, refined, flawless) [Core Expansion 2, Party Box]
Extreme	(exceptional, superlative, radical) [Core Set, Party Box]
Fabulous	(marvelous, wonderful, incredible) [Core Set, Party Box]
Fake	(unreal, counterfeit, deceptive) [Core Expansion 2, Party Box]
Famous	(well-known, celebrated, distinguished) [Core Expansion 3, Party Expansion 1]
Fancy	(showy, ornate, decorated) [Core Expansion 1, Party Box]
Fantastic	(awesome, outrageous, imaginary) [Core Expansion 1, Party Box]
Fashionable	(stylish, dashing, current) [Core Expansion 3, Party Expansion 1]
Fast	(swift, quick, rapid) [Core Expansion 3, Party Expansion 1]
Fast & Furious	(wild, reckless, breakneck) [Core Expansion 4, Party Expansion 1]
Fast & Loose	(deceitful, fraudulent, reckless) [Core Expansion 4, Party Expansion 1]
Fat & Happy	(content, satisfied, assured) [Core Expansion 4, Party Expansion 1]
Fearful	(scared, worried) [Junior Set (2nd)]
Feminine	(womanly, ladylike, unmanly) [Core Set, Party Box]
Filthy	(dirty, foul, unclean) [Core Set, Party Box]
Fine	(worthy, delicate, all right) [Core Expansion 2]
Flaky	(foolish, eccentric, crispy) [Core Expansion 3, Party Expansion 1]
Flamboyant	(ornate, pompous, extravagant) [Core Expansion 3, Party Expansion 1]
Flavorful	(tasty, savory, pungent) [Core Expansion 3, Party Expansion 1]
Flawed	(imperfect, defective, unsound) [Core Expansion 3, Party Expansion 1]
Flirtatious	(brazen, saucy, forward) [Core Set, Party Box]
Foot Loose & Fancy Free	(lighthearted, carefree, spontaneous) [Core Expansion 4, Party Expansion 1]
Foreign	(alien, unfamiliar, exotic) [Core Expansion 1, Party Box]
Fragile	(delicate, frail, breakable) [Core Expansion 3, Party Expansion 1]
Fragrant	(aromatic, odorous, perfumed) [Core Set, Party Box]
Frazzled	(exhausted, frayed, worn) [Core Set, Party Box]
Fresh	(new, original, good) [Core Set, Party Box]
Friendly	(affectionate, comforting, welcoming) [Core Expansion 2, Party Box]
Frightening	(scary, horrifying, awesome) [Core Set, Party Box]
Frivolous	(trivial, silly, shallow) [Party Box]
Funky	(groovy, psychedelic, hip) [Core Expansion 1, Party Box]
Fun	(enjoyable, playful, amusing) [Core Expansion 3, Party Expansion 1]
Funny	(amusing, comic, odd) [Core Expansion 1, Party Box]
Furious	(angry, raging, wild) [Core Expansion 1, Party Box]
Fuzzy	(downy, unclear, furry) [Core Expansion 2, Party Box]
Gentle	(tame, mild) [Junior Set (1st) & (2nd)]
Glamorous	(beautiful, dazzling, stylish) [Core Expansion 1, Party Box]
Glitzy	(flashy, showy, gaudy) [Core Expansion 2, Party Box]
Global	(world-wide, spherical, universal) [Core Expansion 2, Party Box]
Gloomy	(dreary, depressing, sullen) [Core Expansion 3, Party Expansion 1]
Glorious	(magnificent, delightful, splendid) [Core Expansion 2, Party Box]
Goody-Goody	(sweet, well-behaved, virtuous) [Core Expansion 2, Party Box]
Goofy	(silly, foolish, giddy) [Core Expansion 3, Party Expansion 1]
Gorgeous	(beautiful, stunning, magnificent) [Core Expansion 3, Party Expansion 1]
Graceful	(elegant, supple, limber) [Core Set, Party Box]
Great	(very good, important) [Kids Set]
Grueling	(demanding, exhausting, strenuous) [Core Expansion 3, Party Expansion 1]
Gruesome	(ghastly, hideous, grisly) [Core Expansion 3, Party Expansion 1]
Grungy	(dirty, shabby, seedy) [Core Expansion 3, Party Expansion 1]
Hale & Hearty	(healthy, vigorous, robust) [Core Expansion 4, Party Expansion 1]
Handsome	(attractive, elegant, fine) [Core Set, Party Box]
Handy	(convenient, available, capable) [Core Expansion 3, Party Expansion 1]
Happy	(glad, jolly) [Kids Set]
Hardworking	(industrious, diligent, busy) [Core Set, Party Box]
Harmful	(hurtful, unhealthy, damaging) [Core Expansion 1, Party Box]
Harsh	(severe, glaring, brutal) [Core Expansion 3, Party Expansion 1]
Haunting	(unforgettable, bewitching, unearthly) [Core Expansion 2, Party Box]
Hazardous	(risky, dangerous, perilous) [Core Expansion 3, Party Expansion 1]
Healthy	(hearty, robust, wholesome) [Core Expansion 2, Party Box]
Heartless	(insensitive, cruel, uncaring) [Core Expansion 1, Party Box]
Helpful	(useful, assisting) [Kids Set]
High & Dry	(abandoned, alone, helpless) [Core Expansion 4, Party Expansion 1]
High & Low	(everywhere, universally, all over) [Core Expansion 4, Party Expansion 1]
High & Mighty	(arrogant, conceited, vain) [Core Expansion 4, Party Expansion 1]
Hilarious	(funny, witty, amusing) [Core Set, Party Box]
Hit & Miss	(sporadic, unreliable, erratic) [Core Expansion 4, Party Expansion 1]
Honorable	(honest, just, virtuous) [Core Set, Party Box]
Hopeless	(pessimistic, desperate, downhearted) [Core Set, Party Box]
Horrifying	(offensive, abominable, disgusting) [Core Set, Party Box]
Hostile	(antagonistic, aggressive, warlike) [Core Set, Party Box]
Hot	(blazing, heated, spicy) [Core Expansion 1, Party Box]
Hot & Bothered	(annoyed, irritated, provoked) [Core Expansion 4, Party Expansion 1]
Hot & Cold	(ambivalent, indecisive, varying) [Core Expansion 4, Party Expansion 1]
Hot & Heavy	(passionate, momentous, serious) [Core Expansion 4, Party Expansion 1]
Hot & Muggy	(sultry, humid, oppressive) [Core Expansion 4, Party Expansion 1]
Hot & Spicy	(zesty, stimulating, pungent) [Core Expansion 4, Party Expansion 1]
Hot & Sweaty	(sweltering, intense, perspiring) [Core Expansion 4, Party Expansion 1]
Huge	(gigantic, immense, important) [Core Expansion 3, Party Expansion 1]
Humorous	(funny, amusing, comical) [Core Expansion 3, Party Expansion 1]
Icky	(sickening, disgusting, repulsive) [Core Expansion 3, Party Expansion 1]
Ideal	(perfect, flawless, model) [Core Expansion 3, Party Expansion 1]
Idiotic	(foolish, dumb, moronic) [Core Set, Party Box]
Important	(significant, substantial, momentous) [Core Set, Party Box]
Industrious	(diligent, busy, hard-working) [Core Set, Party Box]
Influential	(powerful, prominent, important) [Core Set, Party Box]
Innocent	(guiltless, pure, naive) [Core Expansion 2, Party Box]
Insane	(psychotic, deranged, mad) [Core Expansion 2, Party Box]
Inspirational	(exhilarating, inspiring, stimulating) [Core Set, Party Box]
Insulting	(offending, discourteous, rude) [Core Expansion 2, Party Box]
Intelligent	(bright, smart, brainy) [Core Expansion 1, Party Box]
Intense	(extreme, passionate, strained) [Core Expansion 1, Party Box]
Irresistible	(overpowering, overwhelming, compelling) [Core Expansion 2, Party Box]
Irritating	(annoying, troublesome, provoking) [Core Expansion 1, Party Box]
Jolly	(cheerful, joyous, merry) [Core Expansion 3, Party Expansion 1]
Juicy	(drippy, luscious, tantalizing) [Core Expansion 1, Party Box]
Kind	(nice, helpful) [Junior Set (1st) & (2nd)]
Lazy	(lifeless, apathetic, weary) [Core Expansion 2, Party Box]
Lean & Mean	(vigorous, fit, efficient) [Core Expansion 4, Party Expansion 1]
Legendary	(famous, distinctive, prominent) [Core Expansion 2, Party Box]
Lewd & Lascivious	(lustful, obscene, indecent) [Core Expansion 4, Party Expansion 1]
Light & Fluffy	(billowy, airy, soft) [Core Expansion 4, Party Expansion 1]
Lively	(cheerful, active) [Kids Set]
Long & Lean	(slender, lanky, wiry) [Core Expansion 4, Party Expansion 1]
Loud	(noisy, boisterous, deafening) [Core Set, Party Box]
Loud & Clear	(definite, explicit, unequivocal) [Core Expansion 4, Party Expansion 1]
Lovable	(adorable, endearing, cuddly) [Core Expansion 1, Party Box]
Loving	(caring, kind) [Junior Set (1st) & (2nd)]
Lucky	(fortunate, serendipitous, favored) [Core Set, Party Box]
Lumpy	(bumpy, clumpy) [Kids Set]
Luscious	(delicious, savory, juicy) [Core Set, Party Box]
Luxurious	(opulent, lavish, sumptuous) [Core Set, Party Box]
Magical	(enchanting, miraculous, marvelous) [Core Set, Party Box]
Manly	(masculine, virile, strong) [Core Expansion 2, Party Box]
Masculine	(male, manly, virile) [Core Set, Party Box]
Mean	(unkind, nasty) [Kids Set]
Meek	(shy, mild, timid) [Core Expansion 2, Party Box]
Meek & Mild	(timid, docile, gentle) [Core Expansion 4, Party Expansion 1]
Melodramatic	(theatrical, sensational, showy) [Party Box]
Mesmerizing	(fascinating, hypnotizing, charming) [Core Expansion 3, Party Expansion 1]
Messy	(sloppy, disorderly, unclean) [Core Expansion 3, Party Expansion 1]
Mischievous	(naughty, prankish, sly) [Core Set, Party Box]
Miserable	(wretched, pitiful, forlorn) [Core Expansion 2, Party Box]
Misunderstood	(not grasped, not learned, not absorbed) [Core Set, Party Box]
Mushy	(soft, squishy) [Junior Set (1st) & (2nd)]
Mysterious	(secretive, puzzling, strange) [Core Expansion 1, Party Box]
Mystical	(spiritual, secretive, esoteric) [Core Expansion 2, Party Box]
Naive	(unsophisticated, childlike, simple) [Core Expansion 1, Party Box]
Nasty	(mean, inclement, offensive) [Core Set, Party Box]
Natural	(pure, simple, unadorned) [Core Expansion 1, Party Box]
Naughty & Nice	(impish, mischievous, playful) [Core Expansion 4, Party Expansion 1]
Neat	(tidy, orderly, cool) [Core Expansion 2, Party Box]
Neat & Clean	(spotless, tidy, shipshape) [Core Expansion 4, Party Expansion 1]
Neglected	(ignored, disregarded, rejected) [Core Expansion 2, Party Box]
Nerdy	(unhip, uncool, dorky) [Core Set, Party Box]
New & Improved	(upgraded, enhanced, revised) [Core Expansion 4, Party Expansion 1]
Noisy	(loud, not quiet) [Kids Set]
Normal	(usual, common, ordinary) [Core Set, Party Box]
Nutty	(kooky, foolish, nutlike) [Core Expansion 3, Party Expansion 1]
Obnoxious	(offensive, repulsive, annoying) [Core Set, Party Box]
Obscene	(offensive, indecent, lewd) [Core Expansion 3, Party Expansion 1]
Odd	(different, eccentric, bizarre) [Core Set, Party Box]
Offensive	(insulting, vulgar, attacking) [Core Set, Party Box]
Old	(aged, elderly, antiquated) [Core Expansion 3, Party Expansion 1]
Old & Cranky	(crabby, cantankerous, aged) [Core Expansion 4, Party Expansion 1]
Old & Wise	(experienced, judicious, shrewd) [Core Expansion 4, Party Expansion 1]
On The Up & Up	(trustworthy, irreproachable, honest) [Core Expansion 4, Party Expansion 1]
Orderly	(methodical, formal, systematic) [Core Expansion 2]
Ordinary	(usual, common, plain) [Core Set (2001 Printing Forward), Party Box]
Organic	(natural, clean, biological) [Core Expansion 2, Party Box]
Outrageous	(shocking, scandalous, disgraceful) [Core Set, Party Box]
Overwhelming	(exhaustive, breathtaking, monumental) [Core Expansion 1, Party Box]
Painful	(hurtful, agonizing, unbearable) [Core Expansion 1, Party Box]
Pale	(faded, colorless) [Junior Set (2nd)]
Pathetic	(pitiful, distressing, heart-rending) [Core Expansion 2, Party Box]
Patriotic	(nationalistic, loyal, public-spirited) [Core Set, Party Box]
Peaceful	(serene, restful, calm) [Core Expansion 1, Party Box]
Perfect	(faultless, consummate, exact) [Core Set, Party Box]
Perverse	(stubborn, obstinate, improper) [Core Expansion 3, Party Expansion 1]
Phony	(false, artificial, imitation) [Core Set, Party Box]
Plain	(simple, evident, ordinary) [Core Set (1999 Printing Only)]
Plain & Simple	(unadorned, uncomplicated, clear) [Core Expansion 4, Party Expansion 1]
Playful	(fun, frisky, entertaining) [Core Expansion 1, Party Box]
Pleasant	(enjoyable, nice) [Junior Set (2nd)]
Plug & Play	(effortless, automatic, self-operating) [Core Expansion 4, Party Expansion 1]
Plump & Tender	(ripe, chubby, fleshy) [Core Expansion 4, Party Expansion 1]
Poor	(not rich, unfortunate) [Junior Set (2nd)]
Popular	(well-liked, accepted, preferred) [Core Expansion 2, Party Box]
Powerful	(strong, forceful, robust) [Core Set, Party Box]
Practical	(useful, helpful) [Junior Set (2nd)]
Pretty	(lovely, attractive, good-looking) [Core Expansion 3, Party Expansion 1]
Prim & Proper	(reserved, modest, prudish) [Core Expansion 4, Party Expansion 1]
Primitive	(prehistoric, primal, uncivilized) [Core Set, Party Box]
Principled	(conscientious, ethical, scrupulous) [Core Set, Party Box]
Profound	(deep, wise, thoughtful) [Core Set, Party Box]
Puffy	(swollen, billowy, bloated) [Core Expansion 2, Party Box]
Pure	(innocent, unadulterated, chaste) [Core Set, Party Box]
Quick & Dirty	(cheap, shoddy, inferior) [Core Expansion 4, Party Expansion 1]
Quiet	(peaceful, silent, calm) [Core Expansion 2, Party Box]
Radiant	(shining, glowing, sparkling) [Core Expansion 1, Party Box]
Radical	(unconventional, revolutionary, extreme) [Core Set, Party Box]
Rare	(scarce, unusual, half-cooked) [Core Expansion 1, Party Box]
Raw	(crude, uncooked, harsh) [Core Expansion 3, Party Expansion 1]
Realistic	(authentic, lifelike, reasonable) [Core Expansion 1, Party Box]
Refreshing	(brisk, invigorating, rejuvenating) [Core Expansion 1, Party Box]
Refined	(well-bred, purified, cultivated) [Core Expansion 2, Party Box]
Relaxing	(restful, calming, peaceful) [Core Expansion 2, Party Box]
Repulsive	(disgusting, offensive, foul) [Core Expansion 2, Party Box]
Respectable	(worthy, honorable, decent) [Core Expansion 3, Party Expansion 1]
Responsible	(accountable, obligated, mature) [Core Set, Party Box]
Revolutionary	(innovative, rebellious, radical) [Core Expansion 1, Party Box]
Rich	(wealthy, affluent, moneyed) [Core Set, Party Box]
Ridiculous	(preposterous, absurd, ludicrous) [Core Set, Party Box]
Risky	(hazardous, daring, speculative) [Core Expansion 1, Party Box]
Rough	(scratchy, uneven, jagged) [Core Set, Party Box]
Rough & Ready	(crude, makeshift, prepared) [Core Expansion 4, Party Expansion 1]
Sad	(unhappy, gloomy) [Junior Set (1st) & (2nd)]
Saintly	(virtuous, angelic, divine) [Core Set, Party Box]
Sappy	(gooey, mushy, romantic) [Core Set, Party Box]
Scary	(frightening, absurd, ugly) [Core Set, Party Box]
Scenic	(picturesque, dramatic, panoramic) [Core Expansion 1, Party Box]
Secretive	(concealed, covert, veiled) [Core Expansion 3, Party Expansion 1]
Selfish	(stingy, greedy, miserly) [Core Set, Party Box]
Sensational	(thrilling, startling, melodramatic) [Core Expansion 3, Party Expansion 1]
Senseless	(meaningless, absurd, foolish) [Core Expansion 2, Party Box]
Sensitive	(susceptible, sympathetic, tender) [Core Set, Party Box]
Sensual	(tactile, pleasing, sexual) [Core Set, Party Box]
Sexy	(arousing, appealing, seductive) [Core Set, Party Box]
Shallow	(superficial, trivial, not deep) [Core Expansion 2, Party Box]
Sharp	(pointed, keen, acute) [Core Expansion 2, Party Box]
Shiny	(reflective, gleaming, polished) [Core Expansion 1, Party Box]
Shocking	(frightening, electrifying, startling) [Core Expansion 1, Party Box]
Short & Stout	(plump, portly, tubby) [Core Expansion 4, Party Expansion 1]
Short & Sweet	(precise, clear-cut, succinct) [Core Expansion 4, Party Expansion 1]
Shy	(bashful, timid, cautious) [Core Expansion 1, Party Box]
Sick & Tired	(worn out, exhausted, exasperated) [Core Expansion 4, Party Expansion 1]
Sick & Twisted	(depraved, wicked, lascivious) [Core Expansion 4, Party Expansion 1]
Sickening	(nauseating, disgusting, revolting) [Core Expansion 3, Party Expansion 1]
Silent	(quiet, still) [Junior Set (1st) & (2nd)]
Silly	(goofy, absurd, nonsensical) [Core Expansion 1, Party Box]
Simple	(plain, easy) [Junior Set (1st) & (2nd)]
Skinny	(thin, lean) [Kids Set]
Slimy	(slippery, gooey) [Junior Set (1st) & (2nd)]
Sloppy	(messy, careless) [Kids Set]
Slow & Steady	(reliable, deliberate, ponderous) [Core Expansion 4, Party Expansion 1]
Sluggish	(inactive, lazy, slothful) [Core Expansion 3, Party Expansion 1]
Smart	(intelligent, stylish, witty) [Core Expansion 2, Party Box]
Smelly	(stinky, odorous, rank) [Core Expansion 2, Party Box]
Smooth	(even, level, flat) [Core Set, Party Box]
Smooth & Creamy	(silky, velvety, rich) [Core Expansion 4, Party Expansion 1]
Snappy	(stylish, trendy, fast) [Core Expansion 2, Party Box]
Soft	(malleable, pliable, mushy) [Core Set, Party Box]
Sophisticated	(urbane, cosmopolitan, complex) [Core Expansion 3, Party Expansion 1]
Special	(distinctive, unique, original) [Core Expansion 3, Party Expansion 1]
Speedy	(quick, rapid, fast) [Core Set, Party Box]
Spic & Span	(spotless, tidy, clean) [Core Expansion 4, Party Expansion 1]
Spicy	(flavorable, tangy, hot) [Core Expansion 1, Party Box]
Spiritual	(religious, inspired, supernatural) [Core Expansion 1, Party Box]
Spooky	(scary, weird, ghostly) [Core Expansion 1, Party Box]
Sporty	(athletic, active) [Junior Set (2nd)]
Spunky	(perky, lively, spirited) [Core Expansion 1, Party Box]
Square	(rectangular, uncool, dull) [Core Expansion 1]
Squeaky Clean	(pure, immaculate, unapproachable) [Core Expansion 1, Party Box]
Stereotyped	(pigeonholed, caricatured, characterized) [Core Set, Party Box]
Stinky	(smelly, bad odor) [Kids Set]
Strange	(odd, unusual) [Kids Set]
Stunning	(astonishing, staggering, astounding) [Core Set, Party Box]
Stupid	(ignorant, unintelligent, inane) [Core Expansion 3, Party Expansion 1]
Sultry	(sweltering, humid, sensual) [Core Expansion 2, Party Box]
Sweet	(sugary, caring, good) [Core Set, Party Box]
Swift	(quick, speedy, expeditious) [Core Set, Party Box]
Swift & Sure	(steady, prompt, definite) [Core Expansion 4, Party Expansion 1]
Talented	(gifted, clever, skillful) [Core Set, Party Box]
Tall	(not short, not low) [Kids Set]
Tame	(subdued, gentle, trained) [Core Expansion 2, Party Box]
Tasty	(flavorful, savory, appetizing) [Core Expansion 3, Party Expansion 1]
Technological	(scientific, futuristic, mechanical) [Core Expansion 1, Party Box]
Junior Setting	(seductive, enticing, alluring) [Core Expansion 3, Party Expansion 1]
Tender	(soft, compassionate, fragile) [Core Expansion 3, Party Expansion 1]
Terrific	(sensational, fabulous, severe) [Core Expansion 3, Party Expansion 1]
Thick & Chunky	(bulky, heavy, lumpy) [Core Expansion 4, Party Expansion 1]
Thoughtful	(caring, unselfish) [Junior Set (2nd)]
Timeless	(classic, ageless, well-established) [Core Set, Party Box]
Tormenting	(torturing, harassing, agonizing) [Core Expansion 3, Party Expansion 1]
Torn & Tattered	(shabby, ragged, grungy) [Core Expansion 4, Party Expansion 1]
Touch & Go	(indecisive, uncertain, insecure) [Core Expansion 4, Party Expansion 1]
Touchy-Feely	(affectionate, tactile, huggy) [Core Set, Party Box]
Tough	(strong, firm, difficult) [Core Expansion 1, Party Box]
Trashy	(shameless, nasty, indecent) [Core Expansion 3, Party Expansion 1]
Tried & True	(tested, proven, trustworthy) [Core Expansion 4, Party Expansion 1]
True & Blue	(loyal, faithful, patriotic) [Core Expansion 4, Party Expansion 1]
Trustworthy	(honest, reliable, unfailing) [Core Set, Party Box]
Twisted	(distorted, warped, perverted) [Core Expansion 2, Party Box]
Unbelievable	(incredible, far-fetched, impossible) [Party Box]
Unforgettable	(notable, impressive, remarkable) [Core Set, Party Box]
Unhappy	(sad, sorrowful) [Junior Set (1st) & (2nd)]
Unhealthy	(risky, sickly, dangerous) [Core Expansion 2, Party Box]
Unnatural	(abnormal, artificial, bizarre) [Core Expansion 2, Party Box]
Unreal	(imaginary, illusionary, unbelievable) [Core Expansion 2, Party Box]
Unscrupulous	(unethical, corrupt, unprincipled) [Core Set, Party Box]
Unusual	(rare, odd, uncommon) [Core Expansion 2, Party Box]
Up & Coming	(promising, enterprising, gifted) [Core Expansion 4, Party Expansion 1]
Up & Down	(volatile, variable, vertical) [Core Expansion 4, Party Expansion 1]
Useless	(worthless, ineffective, unneeded) [Core Expansion 1, Party Box]
Vain	(conceited, arrogant, fruitless) [Core Expansion 3, Party Expansion 1]
Violent	(furious, vicious, destructive) [Core Expansion 1, Party Box]
Virtuous	(worthy, righteous, chaste) [Core Expansion 2, Party Box]
Visionary	(idealistic, prophetic, far-seeing) [Core Set, Party Box]
Warm	(tepid, mild, affectionate) [Core Expansion 2]
Warm & Cozy	(snug, comfy, friendly) [Core Expansion 4, Party Expansion 1]
Warm & Fuzzy	(kindhearted, loving, affectionate) [Core Expansion 4, Party Expansion 1]
Wash & Wear	(durable, easy-care, sturdy) [Core Expansion 4, Party Expansion 1]
Weird	(abnormal, peculiar, odd) [Core Expansion 1, Party Box]
Wet	(watery, soaked) [Kids Set]
Whimsical	(humourous, peculiar, fanciful) [Core Expansion 3, Party Expansion 1]
Wicked	(evil, corrupt, depraved) [Core Set, Party Box]
Wild	(untamed, savage, ferocious) [Core Set, Party Box]
Wild & Wooly	(untamed, uncontrolled, reckless) [Core Expansion 4, Party Expansion 1]
Wired	(strained, tense, nervous) [Core Expansion 3, Party Expansion 1]
Witty	(clever, humorous, cunning) [Core Expansion 1, Party Box]
Woebegone	(dismal, sorrowful, bummed out) [Core Expansion 1, Party Box]
Worldly	(experienced, sophisticated, materialistic) [Core Expansion 1, Party Box]
Young	(not old, new) [Junior Set (1st) & (2nd)]
Young & Restless	(fidgety, impatient, flighty) [Core Expansion 4, Party Expansion 1]
Zany	(crazy, funny, wacky) [Core Set, Party Box]
